################################################################################################## 
#                                                                                                # 
#                                                                                                # 
#            ##########                                                                          # 
#           ###########             #######                              ##      ##              # 
#            ############            ########                            ##      ##              # 
#            #########                #########                          ##########              # 
#                                                                        ##########              # 
#                                                                        ##########              # 
#                                                                        ##      ##              # 
########                         ###################                     ##      ##              # 
####                            ##################                                               # 
########                       #################                                                 # 
########                      ################                                           ######### 
#                                                                                     ############ 
#                                                                                   ############## 
#                                                                                                # 
#                      ############                              ##########                      # 
#                      ############                               ########                       # 
#                      ############                              ##########                      # 
######                 ############                               ########                       # 
######                                                                                           # 
###                                      ##                ##                                    # 
#                       ##               ##                ##                                    # 
#                       ##               #####             ##                                    # 
#                       ##               #####             ##              ########              # 
#                       ##               ##                ##              ######                # 
#                       ##                                 ##              ###########           # 
#                       ##                                                                       # 
################################################################################################## 